....................
....................
....................
....................
......######........
......#.............
......#.............
....................
....................
...............#....
...............#....
...............#....
...........#####....
....................
....................