....................
....................
....................
.........#####......
.............#......
.............#......
....................
....................
......######........
......#.............
......#.............
......#.............
....................
....................
....................